[entity-name]
stone=Stone
wooden-chest=Wooden chest
copper-ore=Copper ore
iron-ore=Iron ore
coal=Coal
stone-furnace=Stone furnace
steel-furnace=Steel furnace
electric-furnace=Electric furnace
transport-belt=Transport belt
fast-transport-belt=Fast transport belt
express-transport-belt=Express transport belt
underground-belt=Underground belt
fast-underground-belt=Fast underground belt
express-underground-belt=Express underground belt
loader=Loader
fast-loader=Fast loader
express-loader=Express loader
electric-mining-drill=Electric mining drill
burner-mining-drill=Burner mining drill
gun-turret=Gun turret
rocket-turret=Rocket turret
laser-turret=Laser turret
flamethrower-turret=Flamethrower turret
burner-inserter=Burner inserter
inserter=Inserter
long-handed-inserter=Long handed inserter
fast-inserter=Fast inserter
filter-inserter=Filter inserter
stack-inserter=Stack inserter
stack-filter-inserter=Stack filter inserter
iron-chest=Iron chest
steel-chest=Steel chest
construction-robot=Construction robot
logistic-robot=Logistic robot
logistic-chest-active-provider=Active provider chest
logistic-chest-passive-provider=Passive provider chest
logistic-chest-storage=Storage chest
logistic-chest-requester=Requester chest
beacon=Beacon
car=Car
tank=Tank
straight-rail=Straight rail
straight-rail-remnants=Straight rail remnants
curved-rail=Curved rail
curved-rail-remnants=Curved rail remnants
offshore-pump=Offshore pump
small-pump=Small pump
pipe=Pipe
pipe-to-ground=Pipe to ground
diesel-locomotive=Diesel locomotive
boiler=Boiler
copper-cable=Copper cable
small-electric-pole=Small electric pole
steam-engine=Steam engine
assembling-machine-1=Assembling machine 1
assembling-machine-2=Assembling machine 2
assembling-machine-3=Assembling machine 3
oil-refinery=Oil refinery
chemical-plant=Chemical plant
biter-spawner=Biter spawner
rocket=Rocket
land-mine=Land mine
fish=Fish
solar-panel=Solar panel
small-biter=Small biter
small-biter-corpse=Small biter corpse
medium-biter=Medium biter
medium-biter-corpse=Medium biter corpse
big-biter=Big biter
behemoth-biter=Behemoth biter
big-biter-corpse=Big biter corpse
behemoth-biter-corpse=Behemoth biter corpse
biter-spawner-corpse=Biter spawner corpse
small-spitter=Small spitter
small-spitter-corpse=Small spitter corpse
medium-spitter=Medium spitter
medium-spitter-corpse=Medium spitter corpse
big-spitter=Big spitter
behemoth-spitter=Behemoth spitter
big-spitter-corpse=Big spitter corpse
behemoth-spitter-corpse=Behemoth spitter corpse
spitter-spawner=Spitter spawner
spitter-spawner-corpse=Spitter spawner corpse
radar=Radar
stone-wall=Stone wall
gate=Gate
lab=Lab
player=Player
player-port=Player port
item-on-ground=Item on ground
small-lamp=Lamp
space-module-wreck=Space module wreckage
rocket-silo=Rocket silo
roboport=Roboport
splitter=Splitter
fast-splitter=Fast splitter
express-splitter=Express splitter
market=Market
train-stop=Train stop
rail-signal=Rail signal
rail-chain-signal=Rail chain signal
cargo-wagon=Cargo wagon
decider-combinator=Decider combinator
arithmetic-combinator=Arithmetic combinator
constant-combinator=Constant combinator
power-switch=Power switch
big-electric-pole=Big electric pole
medium-electric-pole=Medium electric pole
accumulator=Accumulator
substation=Substation
small-worm-turret=Small worm
medium-worm-turret=Medium worm
big-worm-turret=Big worm
small-worm-corpse=Small worm corpse
medium-worm-corpse=Medium worm corpse
big-worm-corpse=Big worm corpse
defender=Defender
distractor=Distractor
destroyer=Destroyer
small-remnants=Small remnants
medium-remnants=Medium remnants
big-remnants=Big Remnants
small-scorchmark=Small scorchmark
wall-remnants=Wall remnants
storage-tank=Storage tank
pumpjack=Pumpjack
crude-oil=Crude oil
tree-01=Tree
tree-02=Tree
tree-02-red=Red tree
tree-03=Tree
tree-04=Tree
tree-05=Tree
tree-06=Tree
tree-06-brown=Brown tree
tree-07=Tree
tree-08=Tree
tree-08-brown=Brown tree 
tree-08-red=Red tree 
tree-09=Tree
tree-09-brown=Brown tree
tree-09-red=Red tree
tree-01-stump=Tree stump
tree-02-stump=Tree stump
tree-03-stump=Tree stump
tree-04-stump=Tree stump
tree-05-stump=Tree stump
tree-06-stump=Tree stump
tree-07-stump=Tree stump
tree-08-stump=Tree stump
tree-09-stump=Tree stump
dead-tree=Dead tree
dry-tree=Dry tree
dead-grey-trunk=Dead grey trunk
dry-hairy-tree=Dry hairy tree
dead-dry-hairy-tree=Dead dry hairy tree
green-hairy-grass=Green hairy grass
green-carpet-grass=Green carpet grass
green-small-grass=Green small grass
brown-carpet-grass=Brown carpet grass
brown-hairy-grass=Brown hairy grass
brown-asterisk=Brown asterisk
green-asterisk=Green asterisk
red-asterisk=Red asterisk
green-pita=Green pita
green-pita-mini=Green pita mini
brown-cane-cluster=Brown cane cluster
brown-cane-single=Brown cane single
green-coral=Green coral
green-coral-mini=Green coral mini
brown-coral-mini=Brown coral mini
orange-coral-mini=Orange coral mini
brown-fluff=Brown fluff
brown-fluff-dry=Brown fluff dry
garballo=Garballo
garballo-mini-dry=Garballo mini dry
root-A=Small root
root-B=Big root
stone-rock=Stone rock
small-rock=Small rock
green-bush-mini=Green bush mini
big-ship-wreck-1=Large shipwreck
big-ship-wreck-2=Large shipwreck
big-ship-wreck-3=Large shipwreck
medium-ship-wreck=Medium shipwreck
small-ship-wreck=Small shipwreck
big-ship-wreck-grass=Large shipwreck grass
small-ship-wreck-grass=Small shipwreck grass
deconstructible-tile-proxy=Deconstructible tile proxy
item-request-proxy=Item request slot
electric-energy-interface = Electric energy interface
rocket-defense-dummy=!!! not for translation !!!
smart-chest-dummy=!!! not for translation !!!

[equipment-name]
energy-shield-equipment=Energy shield
energy-shield-mk2-equipment=Energy shield MK2
battery-equipment=Battery
battery-mk2-equipment=Battery MK2
solar-panel-equipment=Portable solar panel
fusion-reactor-equipment=Portable fusion reactor
personal-laser-defense-equipment=Personal laser defense
discharge-defense-equipment=Discharge defense
exoskeleton-equipment=Exoskeleton
night-vision-equipment=Nightvision
personal-roboport-equipment=Personal roboport

[fluid-name]
water=Water
crude-oil=Crude oil
light-oil=Light oil
heavy-oil=Heavy oil
petroleum-gas=Petroleum gas
sulfuric-acid=Sulfuric acid
lubricant=Lubricant

[virtual-signal-name]
signal-everything=Everything
signal-anything=Anything
signal-each=Each
signal-1=Signal 1
signal-2=Signal 2
signal-3=Signal 3
signal-4=Signal 4
signal-5=Signal 5
signal-6=Signal 6
signal-7=Signal 7
signal-8=Signal 8
signal-9=Signal 9
signal-0=Signal 0
signal-A=Signal A
signal-B=Signal B
signal-C=Signal C
signal-D=Signal D
signal-E=Signal E
signal-F=Signal F
signal-G=Signal G
signal-H=Signal H
signal-I=Signal I
signal-J=Signal J
signal-K=Signal K
signal-L=Signal L
signal-M=Signal M
signal-N=Signal N
signal-O=Signal O
signal-P=Signal P
signal-Q=Signal Q
signal-R=Signal R
signal-S=Signal S
signal-T=Signal T
signal-U=Signal U
signal-V=Signal V
signal-W=Signal W
signal-X=Signal X
signal-Y=Signal Y
signal-Z=Signal Z
signal-green=Green signal
signal-red=Red signal
signal-blue=Blue signal
signal-yellow=Yellow signal
signal-pink=Pink signal
signal-cyan=Cyan signal
signal-white=White signal
signal-grey=Grey signal
signal-black=Black signal

[item-name]
repair-pack=Repair pack
stone=Stone
wood=Wood
raw-wood=Raw wood
copper-ore=Copper ore
iron-ore=Iron ore
coal=Coal
copper-plate=Copper plate
iron-plate=Iron plate
steel-plate=Steel plate
stone-brick=Stone brick
iron-axe=Iron axe
steel-axe=Steel axe
iron-gear-wheel=Iron gear wheel
iron-stick=Iron stick
copper-cable=Copper cable
pistol=Pistol
submachine-gun=Submachine gun
vehicle-machine-gun=Vehicle machine gun
tank-machine-gun=Vehicle machine gun
rocket-launcher=Rocket launcher
flame-thrower=Flamethrower
flame-thrower-ammo=Flamethrower ammo
flamethrower-turret=Flamethrower turret
electronic-circuit=Electronic circuit
advanced-circuit=Advanced circuit
processing-unit=Processing unit
light-armor=Light armor
heavy-armor=Heavy armor
modular-armor=Modular armor
power-armor=Power armor
power-armor-mk2=Power armor MK2
rocket=Rocket
explosive-rocket=Explosive rocket
firearm-magazine=Firearm magazine
piercing-rounds-magazine=Piercing rounds magazine
laser-turret=Laser turret
solar-panel=Solar panel
fish=Fish
raw-fish=Raw fish
computer=Computer
lab=Lab
science-pack-1=Science pack 1
science-pack-2=Science pack 2
science-pack-3=Science pack 3
alien-science-pack=Alien science pack
red-wire=Red wire
green-wire=Green wire
alien-artifact=Alien artifact
speed-module=Speed module
speed-module-2=Speed module 2
speed-module-3=Speed module 3
productivity-module=Productivity module
productivity-module-2=Productivity module 2
productivity-module-3=Productivity module 3
effectivity-module=Efficiency module
effectivity-module-2=Efficiency module 2
effectivity-module-3=Efficiency module 3
shotgun=Shotgun
combat-shotgun=Combat shotgun
shotgun-shell=Shotgun shells
piercing-shotgun-shell=Piercing shotgun shells
railgun=Railgun
railgun-dart=Railgun darts
defender-capsule=Defender capsule
distractor-capsule=Distractor capsule
destroyer-capsule=Destroyer capsule
poison-capsule=Poison capsule
slowdown-capsule=Slowdown capsule
grenade=Grenade
cluster-grenade=Cluster grenade
discharge-defense-remote=Discharge defense remote
blueprint=Blueprint
blueprint-book=Blueprint book
rail-planner=Rail planner
deconstruction-planner=Deconstruction planner
sulfur=Sulfur
solid-fuel=Solid fuel
plastic-bar=Plastic bar
engine-unit=Engine unit
electric-engine-unit=Electric engine unit
flying-robot-frame=Flying robot frame
explosives=Explosives
battery=Battery
empty-barrel=Empty barrel
crude-oil-barrel=Crude oil barrel
small-plane=Small plane
coin=Coin
cannon-shell=Cannon shell
explosive-cannon-shell=Explosive cannon shell
tank-cannon=Tank cannon
low-density-structure=Low density structure
rocket-fuel=Rocket fuel
rocket-control-unit=Rocket control unit
rocket-part=Rocket part
satellite=Satellite
stone-path=Stone path
concrete=Concrete
hazard-concrete=Hazard concrete
rail=Rail
landfill=Landfill
electric-energy-interface = Electric energy interface

[ammo-category-name]
bullet=Bullet
combat-robot-beam=Combat robot beam
combat-robot-laser=Combat robot laser
laser-turret=Laser turret
rocket=Rocket
shotgun-shell=Shotgun shell
biological=Biological
cannon-shell=Cannon shell
capsule=Capsule
electric=Electric
flame-thrower=Flamethrower
melee=Melee
railgun=Railgun
grenade=Grenade
fluid=Fluid
